Soo cool read the last line may jujube!!!!	The Artist (?)
Dming version sa Egyptian Creation Story!!!	The Artist (?)
5% marunong na mag guitara :)	The Artist (?)
need : shoes!!! :0	The Consumer (?)
wanna get it naaaaaaaaaaa	The Consumer (?)
need a dress..... stressed out.... damnit!	The Consumer (?)
i am eagerrRRRR to win the ksh tees!!!!!!!!	The Consumer (?)
share!! i want one so cute!	The Consumer (?)
hahaha lipbalm ......	The Consumer (?)
Bro hindi..ganda talaga ng Hilux... Jm Gonzales Raphael Josef Ang Chua	The Consumer (?)
Micro-filter adapter.... tsk.@_@ Jan Kristoffer Cheng Kuw Sia Wap Salonga Ian Kevin Dela Cruz wala padin stock.... taee	The Consumer (?)
Angeline J. Tan donghae	The Fangirl/Fanboy
to nami with jacqoo!	The Fangirl/Fanboy
minho? Francesm Flores	The Fangirl/Fanboy
dream high!!!!! i wanna buy the box lng!!! Angeline J. Tan Kara Ko Cedric Choa Trisha Siytaoco	The Fangirl/Fanboy
psy in myeongdong :))	The Fangirl/Fanboy
kirin!!!! instant karma!!! dream high :)	The Fangirl/Fanboy
Jacqueline Yap was here! (nami)	The Fangirl/Fanboy
go kim! :)	The Fangirl/Fanboy
finally found hakuna matata! :)	The Fangirl/Fanboy
Francesm Flores Davison Engay shinee bagong music na! dazzling girl... ganda :)	The Fangirl/Fanboy
watching golden time :))	The Fangirl/Fanboy
